7
7
XXXXXXX
XM___MX
X_____X
X_$@$_X
X__$__X
X__$__X
XXXXXXX
