7
7
XXXXXXX
XM___MX
X__$__X
X_$@$_X
X__$__X
X_____X
XXXXXXX
